|============|
|==##########|
|###    X@  #|
|#   ##O##  #|
|#   Q X X ##|
|## O##O## #=|
|=#    X   #=|
|=##########=|
||===========|
